NO ./textures/colorstone.xpm
SO ./textures/redbrick.xpm
WE ./textures/wood.xpm
EA ./textures/greystone.xpm

F 53,39,92
C 85,177,217

111111111111111111111
100000000000000000001
100000000000000000001
100000010001001000001
1000000E0000000000001
100000000000000000001
100000000000000000001
100000000000000000001
100000000000000000001
100000000000000000001
111111111111111111111
